{
  "colors": [
    "F6A2AC",
    "94B0E0",
    "FDE79D",
    "A6E0E7",
    "E6A5F1",
    "D2A2F6",
    "A1D9B9",
    "F6A2AC",
    "A7DAA2",
    "8BA9E6",
    "FCF0A1",
    "F4B0A7",
    "FAC8D9",
    "C6D8F5",
    "FFF1C9",
    "D7F1D4",
    "F2D9EB"
  ]
}